XXXXXXXOXXXXXXXXXXXXXXXXXXXXXXXXXXXXXXXXXXXXXXXXXX
XOOOOOOOXOOOOOOOOOOXOOOOOOOOOOOOOOOOOOOOOOOOOOOOOX
XOXXXOXOXOXXXXXXXXOXOXXXXXXXXXOXXXXXXXXXXXXXXXXXOX
XOXPXOXOXOXXXXXPXXOXOXOOOOPOOOOOOOOOOOOOOOOOOOOOOX
XOXOXOXOXOOOOOOOXOOXOXOXXXXXXXXXXXXXXXXXXXXXOXXXXX
XOXOXOXOXXXXXXXXXOXXOXOXOOOOOOOOOOOOOOOOOOOOOOOOOX
XOXOXOXOOOOOOOOOXOOOOXOXOXXXXXXXXXXXXXXXXXXXOXOXOX
XOXOXOXXXXXXXXXOXXXXOXOXOXOOOOOOOOOOOOOOOXPXOXOXOX
XOOOXOOOOOOOOOXOOOOOOXOXOXOXOXXXXXXXXXXXOXOOOXOXOX
XXXOXXXXXXXXXOXXXXXXXXOXOXOXOXOOOOOOOOOXOXXXXXOXOX
XOOOOOOOOOOOOOOOOOOOOOOXOOOXOOOXXXXXXXOXOXOOOOOXOX
XOXXXXXXXXXXXOXXXXXXXXXXXXXXOXOXPOOOOOOXOXOXXXXXOX
XOXOOOOOOOOOOOOOOPOOOOOOOOOOOXOXXXXXXXXXOXOXOOOOOX
XOXOXXXXXXXXXXXXXXXXXXXXXXXXXXOOOOOOOOOOOXOXOXXXXX
XOXOXOOOOOPOOOOOOOOOOOOOOOOOOXXXXXXXXXXXOXOXOXOOOX
XOXOXOXXXXXXXXXXXXXXXXXXXOXXOOOOOOOOOOOOPXOXOXOXOX
XOXOXOOOOOXOOOOOOOOOOOOOOOOXXXXXXXXXXXXXXXOXOXOXOX
XOXOXXXXXOXOXXXXXXXXXXXXXXOOOOOOOOOOOOOOOOOXOXOXOX
XOXOXOOOOOXOXOOOOOOOOOOOOXXXXXXXXXXXXXXXXXOXOXOXOX
XOXOXOXXXXXOXOXXOXXXXXOXOOOOOOOOOOOOOOOOOXOXOXOXOX
XOXOXOOOOOXOXOXOOOXPOOOXXXXXXXXXXOXXXXXXOXOXOXOXOX
XOXOXXXXXOXOXOXOXOXXXXOOXOOOOOOOOOXPXOOOOXPOOOOXOX
XOXOXOOOOOXOXOXOXOXXXXXOXOXXXXXXXXXOXOXOXXOXXXXXOX
XOXOXOXXXXXOXOXOXOOOOOXOXOXOOOOOOOOOXOXOOOOOOOOOOX
XOOPXOXPOOOOXOXOXOXOXOXOXOXOXXXXXXXOXOXOXXXXXXXOXX
XOXXXOXXXXXXXOXOXOXOXOXOXOXOXOOOOOOOOOXOOOOOOOOOXX
XOOOOOOOOOOOOOXOXOXOXOXOXOXOXOXXXXOXXXXOXOXXXXXOXX
XXXXXOXXXXXXXXXOXOXOXOXOXOXOXOXOPXOXOOOOXOXPOOOOOX
XOOOOOOOOOOOOOOOXOXOXOXOXOXOXOXOXXOXOXXXXOXXXXXXOX
XOXXXXXXXXXXXXXXXOXOXOXOXOXOXOXOXXOXOXXXXOOOOOOXOX
XOXOOOOOOOOOOOOOOOXOXOXOXOXOXOXOXXOXOXXXXXXXXXOXOX
XOXOXXXXXOXXXXXOXXXOXOXOXOXOXOXOXXOXOOOOOOOOOOOXOX
XOXOXOOOXOXOOOOOXPXOXOXOXOXPXOXOXXOXOXOXXXXXXXOXOX
XPXOXOXOXOXOXXXOXOOOXOXOOOXOXOXOXXOXOXOXOOOOOXOXOX
XOXOXOXOXOXOOOXOXXXXXOXXXXXOXOXOOOOXOXOXOXXXOXOXOX
XOXOXOXOXOXXXOXOXOOOOOOOOOOOXOXOXXOXOXOXOXPOOXOXOX
XOXOXOXOXOXPXOXOXOXXXXXXXOXOXOXOXXOXOXOXOXOXOXOXOX
XOXOXOXOXOXOXOXOXOOOOOOOOOXOXOXOXXOXOXOXOXOXOXOXOX
XOXOOOXOXOXOOOXOXOXXXXXXXOXOXOXOXXOXOXOXOOOXOXOXOX
XOXXXXXOXOXXXXXOXOXOOOOOXOXOXOXOXXOXOXOXXXXXOXOXOX
XOOOOOXPOOOOOOOOXOXOXXXPXOXOXOXOXXOXOXOOOOOOOXOXOX
XXXXXOXXXXXXXXXXXOXOXXXXXOXOXOXOXXOXOXXXXXXXXXOXOX
XOOOOOOOOOOOOOOOOOXOOOOOOOXOXOXOXXOXOXPOOOOOOXOXOX
XOXOXXXXXXXXXXOXXXXXXXXXXXXOXOXOXXOXOXXXXXXXOXOXOX
XOXOXPOOOOOXOOOOOOOOOOOOOOXOXOXOOOOXOXOOOOOOOXOXOX
XOXOXXXXXXOXOXXXXXXXXXXXXOOOXOXXXXXXOXOXXXXXXXOXOX
XOXOOOOOOOOXOOOOOOOOOOOOXOXOOOOOPOOOOXOOOOOOOOOXPX
XOXXXXXXXXOXXXXXXXOXXXXOXOXXXXXXXXXXXXXXXXXXOXXXOX
XOOOOOOOOOOOOOOOOOOOOOOOXOOOOOOOOOOOOOOOOOOOOOOOOX
XXXXXXXXXXXXXXXXXXXXXXXXXOXXXXXXXXXXXXXXXXXXXXXXXX
