XXXXXXXOXXXXXXXXXXXXXXXXXXXXXXXXXXXXXXXXXXXXXXXXXX
XOOOOOXOXOOOOOOOOOOXOOOOOOOOOOOOOOOOOOOOOOOOOOOOOX
XOXXXOXOXOXXXXXXXXOXOXXXXXXXXXXXXXXXXXXXXXXXXXXXOX
XOXPXOXOXOXXXXXPXXOXOXOOOOPOOOOOOOOOOOOOOOOOOOOOOX
XOXOXOXOXOOOOOOOXOOXOXOXXXXXXXXXXXXXXXXXXXXXXXXXXX
XOXOXOXOXXXXXXXXXOXXOXOXOOOOOOOOOOOOOOOOOOOOOOOOOX
XOXOXOXOOOOOOOOOXOOOOXOXOXXXXXXXXXXXXXXXXXXXOXOXOX
XOXOXOXXXXXXXXXOXXXXOXOXOXOOOOOOOOOOOOOOOXPXOXOXOX
XOOOXOOOOOOOOOXOOOOOOXOXOXOXOXXXXXXXXXXXOXOOOXOXOX
XXXXXXXXXXXXXOXXXXXXXXOXOXOXOXOOOOOOOOOXOXXXXXOXOX
XOOOOOOOOOOOOOOOOOOOOOOXOOOXOXOXXXXXXXOXOXOOOOOXOX
XOXXXXXXXXXXXXXXXXXXXXXXXXXXOXOXPOOOOOOXOXOXXXXXOX
XOXOOOOOOOOOOOOOOPOOOOOOOOOOOXOXXXXXXXXXOXOXOOOOOX
XOXOXXXXXXXXXXXXXXXXXXXXXXXXXXOOOOOOOOOOOXOXOXXXXX
XOXOXOOOOOPOOOOOOOOOOOOOOOOOOXXXXXXXXXXXXXOXOXOOOX
XOXOXOXXXXXXXXXXXXXXXXXXXXXXOOOOOOOOOOOOPXOXOXOXOX
XOXOXOOOOOXOOOOOOOOOOOOOOOOXXXXXXXXXXXXXXXOXOXOXOX
XOXOXXXXXOXOXXXXXXXXXXXXXXOOOOOOOOOOOOOOOOOXOXOXOX
XOXOXOOOOOXOXOOOOOOOOOOOOXXXXXXXXXXXXXXXXXOXOXOXOX
XOXOXOXXXXXOXOXXXXXXXXXXOOOOOOOOOOOOOOOOOXOXOXOXOX
XOXOXOOOOOXOXOXOOOXPOOOXXXXXXXXXXOXXXXXXOXOXOXOXOX
XOXOXXXXXOXOXOXOXOXXXXOOXOOOOOOOOOXPXOOOOXPXOOOXOX
XOXOXOOOOOXOXOXOXOXXXXXOXOXXXXXXXXXOXOXXXXXXXXXXOX
XOXOXOXXXXXOXOXOXOXOOOXOXOXOOOOOOOOOXOXOOOOOOOOOOX
XOXPXOXPOOOOXOXOXOXOXOXOXOXOXXXXXXXXXOXOXXXXXXXOXX
XOXXXOXXXXXXXOXOXOXOXOXOXOXOXOOOOOOOOOXOXOOOOOOOXX
XOOOOOOOOOOOOOXOXOXOXOXOXOXOXOXXXXOXXXXOXOXXXXXXXX
XXXXXXXXXXXXXXXOXOXOXOXOXOXOXOXOPXOXOOOOXOXPOOOOOX
XOOOOOOOOOOOOOOOXOXOXOXOXOXOXOXOXXOXOXXXXOXXXXXXOX
XOXXXXXXXXXXXXXXXOXOXOXOXOXOXOXOXXOXOXXXXOOOOOOXOX
XOXOOOOOOOOOOOOOOOXOXOXOXOXOXOXOXXOXOXXXXXXXXXOXOX
XOXOXXXXXOXXXXXXXXXOXOXOXOXOXOXOXXOXOXOOOOOOOOOXOX
XOXOXOOOXOXOOOOOXPXOXOXOXOXPXOXOXXOXOXOXXXXXXXOXOX
XPXOXOXOXOXOXXXOXOOOXOXOOOXOXOXOXXOXOXOXOOOOOXOXOX
XOXOXOXOXOXOOOXOXXXXXOXXXXXOXOXOXXOXOXOXOXXXOXOXOX
XOXOXOXOXOXXXOXOXOOOOOOOOOOOXOXOXXOXOXOXOXPXOXOXOX
XOXOXOXOXOXPXOXOXOXXXXXXXXXOXOXOXXOXOXOXOXOXOXOXOX
XOXOXOXOXOXOXOXOXOOOOOOOOOXOXOXOXXOXOXOXOXOXOXOXOX
XOXOOOXOXOXOOOXOXOXXXXXXXOXOXOXOXXOXOXOXOOOXOXOXOX
XOXXXXXOXOXXXXXOXOXOOOOOXOXOXOXOXXOXOXOXXXXXOXOXOX
XOOOOOXPXOOOOOOOXOXOXXXPXOXOXOXOXXOXOXOOOOOOOXOXOX
XXXXXOXXXXXXXXXXXOXOXXXXXOXOXOXOXXOXOXXXXXXXXXOXOX
XOOOOOOOOOOOOOOOOOXOOOOOOOXOXOXOXXOXOXPOOOOOOXOXOX
XOXOXXXXXXXXXXXXXXXXXXXXXXXOXOXOXXOXOXXXXXXXOXOXOX
XOXOXPOOOOOXOOOOOOOOOOOOOOXOXOXOOOOXOXOOOOOOOXOXOX
XOXOXXXXXXOXOXXXXXXXXXXXXOXOXOXXXXXXOXOXXXXXXXOXOX
XOXOOOOOOOOXOOOOOOOOOOOOXOXOOOOOPOOOOXOOOOOOOOOXPX
XOXXXXXXXXXXXXXXXXXXXXXOXOXXXXXXXXXXXXXXXXXXXXXXOX
XOOOOOOOOOOOOOOOOOOOOOOOXOOOOOOOOOOOOOOOOOOOOOOOOX
XXXXXXXXXXXXXXXXXXXXXXXXXOXXXXXXXXXXXXXXXXXXXXXXXX
